..........................................s............sssssssssssssssss [  1%]
ssssssssssssssssssssssssssssssssssssssssssssssssssssssssssssssssssssssss [  2%]
sssssssssssssssssssssssssssssssssssssssssssssssssssssssssssssssssss..... [  3%]
......ss................................................................ [  4%]
........................................................................ [  6%]
........................................................................ [  7%]
........................................................................ [  8%]
sssssss................................................................. [  9%]
........................................................................ [ 10%]
........................................................................ [ 12%]
...................................................................s.... [ 13%]
...........ss........................................................... [ 14%]
............................................................s........... [ 15%]
........................................................................ [ 16%]
.................................................s...................... [ 18%]
........................................................................ [ 19%]
.......................s................................................ [ 20%]
..............s......................................................... [ 21%]
........................................................................ [ 22%]
................ss...................................................... [ 24%]
.............................sss....ssssssssssssssssssss........FFF..... [ 25%]
........................................................................ [ 26%]
.s............................s......................................... [ 27%]
.....ss................................................................. [ 28%]
........................................................................ [ 30%]
...........sss...........s.............................................. [ 31%]
........................................................................ [ 32%]
...................................................................sssss [ 33%]
ssssssssssssssssssssssssssssssssssssssssssssssssssssssssssssssssssssssss [ 35%]
ssssssssssssssssssssssssssssssssssssssssssssssssssssssssssssssssssssssss [ 36%]
ssssssssssssssssssssssssssssssssssssssssssssssssssssssssssssssssssssssss [ 37%]
ssssssssssssssssssssssssssss............................................ [ 38%]
.................................s................sssss................. [ 39%]
........................................................................ [ 41%]
............sss......................................................... [ 42%]
...........s..........................sssssssssssssssssssss............. [ 43%]
.s........................ss....ss...................................sss [ 44%]
ssss.................................................................... [ 45%]
........................................................................ [ 47%]
........................................................................ [ 48%]
.......................................ssssssssssss....s................ [ 49%]
........................................................................ [ 50%]
........................................................................ [ 51%]
........................................................................ [ 53%]
..................sssss..s.......s...................................... [ 54%]
.................................................sssssssssssssssssssssss [ 55%]
ssssssssssssssssssssssssssssssssssss...s................................ [ 56%]
........................................................................ [ 57%]
........................................ssss............................ [ 59%]
........................................................................ [ 60%]
................................................................s....... [ 61%]
.........................................s.............................. [ 62%]
..................................sss..sssssssss.......................s [ 64%]
.s......................................sssss..sss......ss.............. [ 65%]
........................................................................ [ 66%]
...........s............s....ss...............................ss..sss.ss [ 67%]
ssss.......................................sssssssssssssssssssssssssss.s [ 68%]
sssss.sssssss.........sss.....s..................sssssssssssssssssssssss [ 70%]
ssssssssssssssssssssssssssssssssssssssssssssssssssssssssssssssssssssssss [ 71%]
sssssssssssssss......................................................... [ 72%]
.......................................................ssssssss......... [ 73%]
...................................................sssss........ssss.... [ 74%]
...............F....F................................................... [ 76%]
........................................................................ [ 77%]
..................................................ssssss................ [ 78%]
........................................................................ [ 79%]
...............s...........s.........s.................................. [ 80%]
.....................................................................ss. [ 82%]
....s..................................................F................ [ 83%]
..FFF..F.FFFFFFF.....FF...F...FF.F..F.................................F. [ 84%]
..F.FF..F....................F.........................ss............... [ 85%]
.......................sssssssssssssssssssssssssssssssssssssssssssssssss [ 86%]
ssssssssssssssssss...............................ss.........s...s.s..... [ 88%]
..............s..................sss......ss............................ [ 89%]
.............................